6,6,6,6,6,6,6,6,6,6,6,6
6,6,6,6,6,6,6,6,6,6,6,6
6,6,6,3,6,6,6,6,0,6,6,6
6,6,0,0,0,6,6,0,0,0,6,6
6,6,0,0,0,0,0,0,0,0,6,6
6,6,0,0,0,6,6,0,0,0,6,6
6,6,6,0,6,6,6,6,0,6,6,6
6,6,6,0,6,6,6,6,0,6,6,6
6,6,0,0,0,6,6,0,0,0,6,6
6,0,0,0,0,0,0,0,0,0,0,6
6,6,0,0,0,6,6,0,0,0,6,6
6,6,6,0,6,6,6,6,0,6,6,6
6,6,6,0,6,6,6,6,0,6,6,6
6,6,0,0,0,6,6,0,0,0,6,6
6,6,0,0,0,0,0,0,0,0,6,6
6,6,0,0,0,6,6,0,0,0,6,6
6,6,6,0,6,6,6,6,1,6,6,6
6,6,6,6,6,6,6,6,6,6,6,6
6,6,6,6,6,6,6,6,6,6,6,6
