8,8,8,8,8,8,8,8,8,8,8,8
8,8,8,8,8,8,8,8,8,8,8,8
8,8,8,3,8,8,8,8,1,8,8,8
8,8,0,0,0,8,8,0,0,0,8,8
8,8,0,0,0,0,0,0,0,0,8,8
8,8,0,0,0,8,8,0,0,0,8,8
8,8,8,0,8,8,8,8,0,8,8,8
8,8,8,0,8,8,8,8,0,8,8,8
8,8,0,0,0,8,8,0,0,0,8,8
8,4,0,0,0,0,0,0,0,0,4,8
8,8,0,0,0,8,8,0,0,0,8,8
8,8,8,0,8,8,8,8,0,8,8,8
8,8,8,0,8,8,8,8,0,8,8,8
8,8,0,0,0,8,8,0,0,0,8,8
8,8,0,0,0,0,0,0,0,0,8,8
8,8,0,0,0,8,8,0,0,0,8,8
8,8,8,3,8,8,8,8,1,8,8,8
8,8,8,8,8,8,8,8,8,8,8,8
8,8,8,8,8,8,8,8,8,8,8,8
